MonthYear,RR,SR,SS,n,freqR,CI_95
Jan-00,0,0,1,1,0,0
Feb-00,0,0,0,0,NA,NA
Mar-00,0,0,0,0,NA,NA
Apr-00,0,0,8,8,0,0
May-00,0,0,0,0,NA,NA
Jun-00,0,0,0,0,NA,NA
Jul-00,0,0,0,0,NA,NA
Aug-00,0,0,0,0,NA,NA
Sep-00,0,1,482,483,0.001035197,0.002027935
Oct-00,0,0,105,105,0,0
Nov-00,0,0,58,58,0,0
Dec-00,4,10,402,416,0.021634615,0.009885976
Jan-01,0,2,310,312,0.003205128,0.004434957
Feb-01,0,0,277,277,0,0
Mar-01,0,1,96,97,0.005154639,0.01007702
Apr-01,0,0,0,0,NA,NA
May-01,0,0,1,1,0,0
Jun-01,1,9,26,36,0.152777778,0.083103361
Jul-01,0,0,0,0,NA,NA
Aug-01,0,0,0,0,NA,NA
Sep-01,0,0,8,8,0,0
Oct-01,0,0,4,4,0,0
Nov-01,0,0,1,1,0,0
Dec-01,0,0,0,0,NA,NA
Jan-02,0,3,16,19,0.078947368,0.08573839
Feb-02,0,0,0,0,NA,NA
Mar-02,0,0,0,0,NA,NA
Apr-02,0,0,1,1,0,0
May-02,0,1,1,2,0.25,0.424352448
Jun-02,0,0,1,1,0,0
Jul-02,0,0,3,3,0,0
Aug-02,0,0,2,2,0,0
Sep-02,0,0,5,5,0,0
Oct-02,1,1,8,10,0.15,0.15649345
Nov-02,0,1,25,26,0.019230769,0.037328122
Dec-02,0,1,0,1,0.5,0.692964646
Jan-03,2,0,5,7,0.285714286,0.236643191
Feb-03,8,18,20,46,0.369565217,0.098634259
Mar-03,18,14,32,64,0.390625,0.084522711
Apr-03,6,7,1,14,0.678571429,0.172988439
May-03,0,1,1,2,0.25,0.424352448
Jun-03,0,3,0,3,0.5,0.400083325
Jul-03,4,9,4,17,0.5,0.168068613
Aug-03,17,14,6,37,0.648648649,0.108771667
Sep-03,4,2,2,8,0.625,0.23722023
Oct-03,14,9,3,26,0.711538462,0.123139546
Nov-03,9,12,14,35,0.428571429,0.115931014
Dec-03,4,9,25,38,0.223684211,0.093688471
Jan-04,36,10,2,48,0.854166667,0.070602514
Feb-04,36,7,1,44,0.897727273,0.063309206
Mar-04,3,2,3,8,0.5,0.245
Apr-04,5,0,0,5,1,0
May-04,30,10,3,43,0.813953488,0.082246496
Jun-04,24,8,6,38,0.736842105,0.099002166
Jul-04,10,2,1,13,0.846153846,0.138687521
Aug-04,0,0,0,0,NA,NA
Sep-04,1,0,0,1,1,0
Oct-04,4,0,0,4,1,0
Nov-04,0,0,0,0,NA,NA
Dec-04,0,0,0,0,NA,NA
Jan-05,4,0,0,4,1,0
Feb-05,1,0,0,1,1,0
Mar-05,1,0,0,1,1,0
Apr-05,125,11,4,140,0.932142857,0.02945887
May-05,9,0,0,9,1,0
Jun-05,20,0,0,20,1,0
Jul-05,12,0,0,12,1,0
Aug-05,2,0,0,2,1,0
Sep-05,29,2,0,31,0.967741935,0.043980399
Oct-05,19,0,0,19,1,0
Nov-05,15,1,0,16,0.96875,0.060285373
Dec-05,10,4,0,14,0.857142857,0.129614814
Jan-06,68,7,0,75,0.953333333,0.033754853
Feb-06,12,0,0,12,1,0
Mar-06,16,0,0,16,1,0
Apr-06,23,3,0,26,0.942307692,0.063373796
May-06,13,0,0,13,1,0
Jun-06,13,0,0,13,1,0
Jul-06,1,0,0,1,1,0
Aug-06,17,1,0,18,0.972222222,0.053682946
Sep-06,8,0,0,8,1,0
Oct-06,5,1,0,6,0.916666667,0.156379761
Nov-06,573,2,0,575,0.99826087,0.002408215
Dec-06,20,10,4,34,0.735294118,0.104860991
Jan-07,23,8,1,32,0.84375,0.088957586
Feb-07,4,0,0,4,1,0
Mar-07,7,1,0,8,0.9375,0.118610115
Apr-07,19,0,0,19,1,0
May-07,1,0,0,1,1,0
Jun-07,12,0,0,12,1,0
Jul-07,38,0,0,38,1,0
Aug-07,8,1,1,10,0.85,0.15649345
Sep-07,0,0,6,6,0,0
Oct-07,4,0,0,4,1,0
Nov-07,10,0,0,10,1,0
Dec-07,8,1,0,9,0.944444444,0.105820979
Jan-08,32,5,4,41,0.841463415,0.079055395
Feb-08,60,7,7,74,0.858108108,0.05621795
Mar-08,20,3,1,24,0.895833333,0.086419837
Apr-08,6,2,0,8,0.875,0.162052268
May-08,6,0,0,6,1,0
Jun-08,10,11,7,28,0.553571429,0.130204167
Jul-08,15,1,0,16,0.96875,0.060285373
Aug-08,29,1,3,33,0.893939394,0.074287406
Sep-08,9,0,1,10,0.9,0.131480797
Oct-08,20,0,0,20,1,0
Nov-08,9,0,0,9,1,0
Dec-08,59,0,0,59,1,0
Jan-09,20,1,3,24,0.854166667,0.099847033
Feb-09,13,4,0,17,0.882352941,0.108299966
Mar-09,17,0,0,17,1,0
Apr-09,0,0,0,0,NA,NA
May-09,3,0,1,4,0.75,0.300062493
Jun-09,30,3,0,33,0.954545455,0.05025405
Jul-09,76,0,0,76,1,0
Aug-09,77,0,1,78,0.987179487,0.017654057
Sep-09,17,0,0,17,1,0
Oct-09,67,1,1,69,0.97826087,0.02433128
Nov-09,32,1,0,33,0.984848485,0.029471134
Dec-09,86,0,0,86,1,0
Jan-10,41,0,0,41,1,0
Feb-10,1,0,0,1,1,0
Mar-10,20,1,0,21,0.976190476,0.046107764
Apr-10,16,0,0,16,1,0
May-10,2,0,0,2,1,0
Jun-10,12,0,0,12,1,0
Jul-10,5,0,0,5,1,0
Aug-10,0,0,0,0,NA,NA
Sep-10,107,0,0,107,1,0
Oct-10,216,0,0,216,1,0
Nov-10,19,0,0,19,1,0
Dec-10,2,0,0,2,1,0
Jan-11,0,0,0,0,NA,NA
Feb-11,24,0,0,24,1,0
Mar-11,0,0,0,0,NA,NA
Apr-11,28,0,0,28,1,0
May-11,176,0,0,176,1,0
Jun-11,64,0,0,64,1,0
Jul-11,44,0,0,44,1,0
Aug-11,13,0,0,13,1,0
Sep-11,69,0,0,69,1,0
Oct-11,34,0,0,34,1,0
Nov-11,16,0,0,16,1,0
Dec-11,0,0,0,0,NA,NA
Jan-12,91,9,3,103,0.927184466,0.035482773
Feb-12,24,0,2,26,0.923076923,0.072427196
Mar-12,8,2,0,10,0.9,0.131480797
Apr-12,8,1,0,9,0.944444444,0.105820979
May-12,17,2,1,20,0.9,0.092970963
Jun-12,48,2,0,50,0.98,0.02744
Jul-12,15,4,0,19,0.894736842,0.0975776
Aug-12,46,0,0,46,1,0
Sep-12,42,6,0,48,0.9375,0.048422377
Oct-12,30,5,1,36,0.902777778,0.068432598
Nov-12,41,4,2,47,0.914893617,0.056410313
Dec-12,3,0,0,3,1,0
Jan-13,0,0,0,0,NA,NA
Feb-13,0,0,0,0,NA,NA
Mar-13,16,0,0,16,1,0
Apr-13,60,0,0,60,1,0
May-13,42,0,0,42,1,0
Jun-13,103,0,0,103,1,0
Jul-13,96,0,0,96,1,0
Aug-13,31,0,1,32,0.96875,0.042628196
Sep-13,1,0,0,1,1,0
Oct-13,0,0,0,0,NA,NA
Nov-13,0,0,0,0,NA,NA
Dec-13,1,0,0,1,1,0
Jan-14,376,0,0,376,1,0
Feb-14,462,0,0,462,1,0
Mar-14,16,0,0,16,1,0
Apr-14,701,0,5,706,0.992917847,0.004373992
May-14,225,0,1,226,0.995575221,0.006118848
Jun-14,417,0,1,418,0.997607656,0.003311652
Jul-14,566,0,0,566,1,0
Aug-14,470,0,0,470,1,0
Sep-14,284,0,0,284,1,0
Oct-14,1329,0,4,1333,0.99699925,0.002076292
Nov-14,515,0,8,523,0.984703633,0.007437674
Dec-14,491,0,0,491,1,0
Jan-15,0,0,0,0,NA,NA
Feb-15,0,0,0,0,NA,NA
Mar-15,131,0,0,131,1,0
Apr-15,22,0,0,22,1,0
May-15,0,0,0,0,NA,NA
Jun-15,0,0,0,0,NA,NA
Jul-15,0,0,0,0,NA,NA
Aug-15,0,0,0,0,NA,NA
Sep-15,2,0,0,2,1,0
Oct-15,0,0,0,0,NA,NA
Nov-15,0,0,0,0,NA,NA
Dec-15,0,0,0,0,NA,NA
Jan-16,3,0,0,3,1,0
Feb-16,2,0,0,2,1,0
Mar-16,0,0,0,0,NA,NA
Apr-16,7,0,0,7,1,0
May-16,36,0,0,36,1,0
Jun-16,183,0,0,183,1,0
Jul-16,224,0,0,224,1,0
Aug-16,0,0,0,0,NA,NA
Sep-16,125,0,0,125,1,0
Oct-16,143,0,0,143,1,0
Nov-16,67,0,0,67,1,0
Dec-16,92,0,0,92,1,0
Jan-17,5,0,1,6,0.833333333,0.210862427
Feb-17,8,0,0,8,1,0
Mar-17,44,0,0,44,1,0
Apr-17,0,0,0,0,NA,NA
May-17,106,0,0,106,1,0
Jun-17,23,0,0,23,1,0
Jul-17,3,0,0,3,1,0
Aug-17,0,0,0,0,NA,NA
Sep-17,130,0,0,130,1,0
Oct-17,235,0,0,235,1,0
Nov-17,0,0,0,0,NA,NA
Dec-17,0,0,0,0,NA,NA